xxxxxxxxxxxxxxxxxxxxxxxxxxxx
x000000000000xx000000000000x
x0xxxx0xxxxx0xx0xxxxx0xxxx0x
x0xxxx0xxxxx0xx0xxxxx0xxxx0x
x000xx0000xx0xx0xx0000xx000x
xxx0xx0xx0xx0000xx0xx0xx0xxx
  x0xx0xx0xx0xx0xx0xx0xx0x  
  x0xx0xx0xx0xx0xx0xx0xx0x  
  x0000xx0000xx0000xx0000x  
  x0xxxxx xxxxxxxx xxxxx0x  
  x0xxxxx xxxxxxxx xxxxx0x  
  x0000              0000x
  x xx0xx xxx__xxx xx0xx x
